############
#P   C    I#
#          #
#   C ##   #
# C       I#
#      I   #
#          #
############