          ####
     #### #  #
   ###  ###C #
  ##      C  #
 ##  P C ## ##
 #  #C##C    #
 # #  C  C# ###
 #     #  # C #####
####    # CCC #   #
#### ##         C #
#     ###  ########
#II II# ####
#III#I#
#IIII##
#######
